NO ./textures/bluestone.xpm
SO ./textures/redbrick.xpm
WE ./textures/wood.xpm
EA ./textures/eagle.xpm

F 48,60,32
C 90,213,255

1111111111
1000100001
1001000001
10001000011111
10000000000001
10000W10011101
10000100011101
10000000000001
10000000011111
1000000001
1111111111