1211111121
2000000002
1021000001
1000020001
1000000001
10000N0101
1030000001
1000000001
3000030003
1311111131