
F           48,60,32
C 90,213, 256

NO ./textures/bluestone.xpm
SO ./textures/redbrick.xpm
WE ./textures/wood.xpm
EA ./textures/eagle.xpm


         1
        1S1
       10001
      1000001
     100000001
    10000000001
   1111111111111
