NO ./textures/bluestone.xpm
SO ./textures/redbrick.xpm
WE ./textures/wood.xpm
EA ./textures/eagle.xpm

F 48,60,32
C 90,213,255

1111111111
1000000001
1001000001
1000100001
1000000001
10000N1001
1000010001
1000000001
1000000001
1111111111