1111111111111111111111111
1000000000000000000300001
1000000000000000000000001
1000000000000000000030031
1002000000200000000000001
1000000011000000000000031
1000000000000000002000001
1000000300000000000000001
1001000000000003000000001
1000200000000000000000011
1030000020000000000000001
100000000000000N000000001
1000030300001000000000001
1000000000000000000000001
1000000000000000000000001
1000000002100000000000001
1000000000000000000000001
1000000000000000000010201
1000000000000000000000001
1000000000000100000000001
1000011000000000000000001
1000000000000000000000001
1000003000000200000000001
1020000002000000000000001
1111111111111111111111111