NO ./textures/bluestone.xpm
SO ./textures/redbrick.xpm
WE ./textures/wood.xpm
EA ./textures/mossy.xpm

F 220,100,0
C 225,30,0

1111111111111111111111111
1000000000000000000100001
1000000000000000000000001
1000000000000000000010011
1001000000100000000000001
1000000011000000000000011
1000000000000000001000001
1000000100000000000000001
1001000000000001000000001
1000100000000000000000011
1030000010000000000000001
100000000000000N000000001
1000010100001000000000001
1000000000000000000000001
1000000000000000000000001
1000000001100000000000001
1000000000000000000000001
1000000000000000000010101
1000000000000000000000001
1000000000000100000000001
1000011000000000000000001
1000000000000000000000001
1000001000000100000000001
1010000001000000000000001
1111111111111111111111111