    WE                  ./textures/wood.xpm
NO       ./textures/bluestone.xpm


SO ./textures/redbrick.xpm

F       48,60,32

EA ./textures/eagle.xpm



C 90,213,255

        1111111111111111111111111
        1000000000110000000000001
        1011000001110000000000001
        1001000000000000000000001
111111111011000001110000000000001
100000000011000001110110111111111
11110111111111011100000010001
11110111111111011101010010001
11000000110101011100000010001
10000000000000000000000000001
10000000000000001101010010001
110000011101010111110111100N1
11110111 1110101 101111010001
11111111 1111111 111111111111
